18 18 18 18 18 18 18 18 18 18 18 18 18 18 18 18 18 18 18 18 18 18 18 18 18 18 18 18 18 18 18 18 18 18 18 18 18 18 18 18 18 18 18 18 18 18 18 18 18 18 
18 18 18 18 18 18 18 18 18 18 18 18 18 18 18 18 18 18 18 18 18 18 18 18 18 18 18 18 18 18 18 18 18 18 18 18 18 18 18 18 18 18 18 18 18 18 18 18 18 18 
18 18 18 18 18 18 18 18 18 18 18 18 18 18 18 18 18 18 18 18 18 18 18 18 18 18 18 18 18 18 18 18 18 18 18 18 18 18 18 18 18 18 18 18 18 18 18 18 18 18 
18 18 18 18 18 18 18 18 18 18 18 18 18 18 18 18 18 18 18 18 18 18 18 18 18 18 18 18 18 18 18 18 18 18 18 18 18 18 18 18 18 18 18 18 18 18 18 18 18 18 
18 18 18 18 18 18 18 18 18 18 18 18 18 18 18 18 18 18 18 18 18 18 18 18 18 18 18 18 18 18 18 18 18 18 18 18 18 18 18 18 18 18 18 18 18 18 18 18 18 18 
18 18 18 18 18 18 18 18 18 18 18 18 18 18 18 18 18 18 18 18 18 18 18 18 18 18 18 18 18 18 18 18 18 18 18 18 18 18 18 18 18 18 18 18 18 18 18 18 18 18 
18 18 18 18 18 18 18 18 18 18 18 18 18 18 18 18 18 18 18 18 18 18 18 18 18 18 18 18 18 18 18 18 18 18 18 18 18 18 18 18 18 18 18 18 18 18 18 18 18 18 
18 18 18 28 26 26 26 26 26 26 26 26 29 18 18 18 18 18 18 18 18 18 18 18 18 18 18 18 18 18 18 18 18 18 18 18 18 18 18 18 18 18 18 18 18 18 18 18 18 18 
18 18 18 24 43 43 43 43 43 43 43 43 23 18 18 18 18 18 18 18 18 1 1 1 1 1 1 1 18 18 18 18 18 18 18 18 18 18 18 18 18 18 18 18 18 18 18 18 18 18 
18 18 18 24 43 43 43 43 43 43 43 43 23 18 18 18 18 18 18 18 18 1 20 21 21 21 22 1 18 18 18 18 18 18 18 18 18 18 18 18 18 18 18 18 18 18 18 18 18 18 
18 18 18 24 43 43 43 43 43 43 43 43 23 18 18 18 18 18 18 43 43 1 23 18 18 18 24 1 43 43 43 43 43 43 43 43 2 2 18 18 18 18 18 18 18 18 18 18 18 18 
18 18 18 24 43 43 43 43 43 43 43 43 23 18 18 18 18 18 18 43 43 1 25 26 26 26 27 1 43 43 43 43 43 43 43 43 18 18 18 18 18 18 18 18 18 18 18 18 18 18 
18 18 28 27 43 43 43 43 43 43 43 43 23 18 18 18 18 18 18 43 43 1 1 2 1 1 1 1 43 1 43 43 43 43 43 43 18 18 18 18 18 18 18 18 18 18 18 18 18 18 
18 18 24 43 43 43 43 43 20 21 21 21 31 18 18 18 18 18 18 43 43 1 1 1 1 1 1 1 43 1 1 43 43 43 43 43 18 18 18 18 18 18 18 18 18 18 18 18 18 18 
18 18 24 43 43 43 43 43 23 18 18 18 18 18 18 18 18 18 18 43 43 43 1 43 1 43 1 12 1 1 1 43 43 43 43 43 18 18 18 18 18 18 18 18 18 18 18 18 18 18 
18 18 24 43 43 43 43 43 23 18 18 18 18 18 18 18 18 18 18 43 43 43 43 43 1 1 43 1 43 1 1 43 43 43 43 43 18 18 18 18 18 18 18 18 18 18 18 18 18 18 
18 18 24 43 43 43 43 43 23 28 26 26 26 26 26 26 26 26 26 43 43 43 2 43 1 43 1 17 1 1 43 43 1 43 43 43 29 18 18 18 18 19 18 18 18 18 18 18 18 18 
18 18 24 43 43 43 43 43 23 24 43 43 43 43 43 43 43 43 43 32 32 32 32 32 32 32 32 32 1 1 43 1 43 43 43 43 23 18 18 19 18 18 18 18 19 18 18 18 18 18 
18 18 24 43 43 43 43 43 23 24 43 43 43 43 43 43 43 43 43 32 43 43 2 43 2 43 1 32 1 1 1 43 43 43 43 43 23 18 18 18 18 19 18 18 18 18 18 18 18 18 
18 18 24 43 43 43 43 43 23 24 43 43 43 43 43 43 43 43 43 32 43 43 43 3 43 43 1 32 1 43 43 43 43 43 43 43 23 18 18 18 18 18 18 18 18 19 18 18 18 18 
18 18 24 43 43 43 43 43 23 24 43 43 43 43 43 43 43 43 43 32 43 43 2 43 2 43 2 32 43 43 43 43 43 43 43 43 23 18 18 19 18 18 18 19 18 18 18 18 18 18 
18 18 24 43 43 43 43 43 25 27 43 43 43 43 43 43 43 43 43 32 43 43 43 43 43 43 43 32 43 43 43 43 43 43 43 43 23 18 18 18 18 18 18 18 18 18 18 18 18 18 
18 18 24 43 43 43 43 43 43 43 43 43 43 43 43 43 43 43 43 32 43 43 43 43 43 43 43 32 43 43 43 43 43 43 43 43 23 18 18 19 18 18 18 18 18 18 18 18 18 18 
18 18 24 43 43 43 43 43 43 43 43 43 43 43 43 43 43 43 43 32 43 43 43 43 43 43 43 32 43 60 43 43 43 43 43 43 23 18 18 18 18 18 18 19 18 18 18 18 18 18 
18 18 24 43 43 43 43 43 43 43 43 43 43 43 43 43 43 43 43 32 43 32 32 32 32 32 43 32 43 58 43 43 43 43 43 43 23 18 18 18 18 18 18 18 18 18 18 18 18 18 
18 18 24 43 43 43 43 43 43 43 43 43 43 43 43 43 43 43 43 43 43 43 43 43 43 43 43 43 43 43 43 43 43 43 43 43 23 18 19 18 18 19 18 18 18 18 18 18 18 18 
18 18 30 21 21 21 21 21 21 22 43 43 43 43 43 43 43 43 43 43 43 43 43 43 43 43 43 43 43 43 43 43 43 43 43 43 25 26 26 26 26 26 26 26 26 26 29 18 18 18 
18 18 18 18 18 18 18 18 18 24 43 43 43 43 43 43 43 43 43 43 43 43 43 43 43 43 43 43 43 43 43 43 43 43 43 43 43 43 43 43 43 43 43 43 43 43 23 18 18 18 
18 18 18 18 18 18 18 18 18 30 21 21 21 21 21 21 21 22 43 43 43 43 43 43 43 43 43 43 43 43 43 43 43 43 43 43 43 43 43 43 43 43 43 43 43 43 23 18 18 18 
18 18 18 18 18 18 18 18 18 18 18 18 18 18 18 18 18 24 43 43 43 43 43 43 43 43 43 43 43 43 43 43 43 43 43 43 43 43 43 43 43 43 43 43 43 43 23 18 18 18 
18 18 18 18 18 18 18 18 18 18 18 18 18 28 26 29 18 24 43 43 43 43 43 43 43 43 43 43 43 43 43 43 43 43 43 43 43 43 43 43 43 43 43 43 43 43 23 18 18 18 
18 18 18 18 18 18 18 18 18 18 18 18 18 24 19 23 18 24 43 43 43 43 43 43 43 43 43 43 43 43 43 43 43 43 43 43 43 43 43 43 43 43 43 43 43 43 23 18 18 18 
18 18 18 18 18 18 18 18 18 18 18 18 18 30 21 31 18 24 43 43 43 43 43 43 43 43 43 43 43 43 43 43 43 43 43 43 43 43 43 43 43 43 43 43 43 43 23 18 18 18 
18 18 18 18 18 18 18 18 18 18 18 18 18 18 18 18 18 24 43 43 43 43 43 43 43 43 43 43 43 43 43 43 43 43 43 43 43 43 43 43 43 43 43 43 43 43 23 18 18 18 
18 18 18 18 18 18 18 18 18 18 18 18 18 18 18 18 18 24 43 43 43 43 43 43 43 43 43 43 43 43 43 43 43 43 43 43 43 43 43 43 43 43 43 20 21 21 31 18 18 18 
18 18 18 18 18 18 18 18 18 18 18 18 18 18 18 18 18 24 43 43 43 43 43 43 43 20 21 21 22 43 43 43 43 43 43 43 20 21 21 22 43 43 43 23 18 18 18 18 18 18 
18 18 18 18 18 18 18 18 18 18 18 18 18 18 18 18 18 24 43 43 43 43 43 43 43 25 26 26 27 43 43 43 43 43 20 21 31 18 18 24 43 43 43 23 18 18 18 18 18 18 
18 18 18 18 18 18 18 18 18 18 18 18 18 18 18 18 18 24 43 43 43 43 43 43 43 43 43 43 43 43 43 43 43 43 23 18 18 18 18 24 43 43 43 23 18 18 18 18 18 18 
18 18 18 18 18 18 18 18 18 18 18 18 18 18 18 18 18 24 43 43 43 43 43 43 43 43 43 43 43 43 43 43 43 43 23 18 18 18 18 24 43 43 43 23 18 34 34 34 18 18 
18 18 18 18 18 18 18 18 18 18 18 18 18 18 18 18 18 24 1 1 1 1 1 43 43 43 43 43 43 43 43 43 43 43 23 18 18 18 18 24 43 43 43 23 34 34 34 34 18 18 
18 18 18 18 18 18 18 18 18 18 18 18 18 18 18 18 18 24 1 1 1 1 1 43 43 43 43 43 43 43 43 43 43 43 23 18 18 18 18 24 43 43 43 38 34 34 34 34 18 18 
18 18 18 18 18 18 18 18 18 18 18 18 18 18 18 18 18 24 1 1 1 1 1 43 43 43 43 43 43 43 43 43 43 43 23 18 18 18 18 24 43 43 43 42 34 34 34 34 18 18 
18 18 18 18 18 18 18 18 18 18 18 18 18 18 18 18 18 24 1 1 20 21 22 43 43 43 43 43 43 43 43 43 43 43 23 18 18 18 18 30 21 21 21 31 41 34 34 34 18 18 
18 18 18 18 18 18 18 18 18 18 18 18 18 18 18 18 18 24 1 1 23 18 24 43 43 43 43 43 43 43 43 43 43 43 23 18 18 18 18 18 18 18 18 18 18 41 41 41 18 18 
18 18 18 18 18 18 18 18 18 18 18 18 18 18 18 18 18 30 22 2 23 18 24 43 43 43 43 43 43 43 43 43 43 43 23 18 18 18 18 18 18 18 18 18 18 18 18 18 18 18 
18 18 18 18 18 18 18 18 18 18 18 18 18 18 18 18 18 18 30 21 31 18 30 21 21 21 21 21 21 21 21 21 21 21 31 18 18 18 18 18 18 18 18 18 18 18 18 18 18 18 
18 18 18 18 18 18 18 18 18 18 18 18 18 18 18 18 18 18 18 18 18 18 18 18 18 18 18 18 18 18 18 18 18 18 18 18 18 18 18 18 18 18 18 18 18 18 18 18 18 18 
18 18 18 18 18 18 18 18 18 18 18 18 18 18 18 18 18 18 18 18 18 18 18 18 18 18 18 18 18 18 18 18 18 18 18 18 18 18 18 18 18 18 18 18 18 18 18 18 18 18 
18 18 18 18 18 18 18 18 18 18 18 18 18 18 18 18 18 18 18 18 18 18 18 18 18 18 18 18 18 18 18 18 18 18 18 18 18 18 18 18 18 18 18 18 18 18 18 18 18 18 
18 18 18 18 18 18 18 18 18 18 18 18 18 18 18 18 18 18 18 18 18 18 18 18 18 18 18 18 18 18 18 18 18 18 18 18 18 18 18 18 18 18 18 18 18 18 18 18 18 18 
